330 100 2 6 4 1 1 1 1 310 400
2
0 0 1 1 1 0 0 0 0 0 0 
0 1 0 0 0 0 0 1 1 1 0 
0 1 0 1 0 1 0 1 0 1 0 
0 1 0 1 0 1 0 1 0 1 0 
0 11 0 1 0 1 0 1 1 1 0 
0 12 0 1 11 1 0 1 1 1 0 
3 0 1 1 0 1 0 1 1 1 0 
1 0 1 1 0 0 0 0 0 0 0 
0 0 0 1 1 12 0 1 0 1 1 
0 0 0 0 0 0 0 1 0 1 0 
0 0 0 1 0 0 0 0 0 1 1 
0 0 1 1 1 0 0 0 0 0 0 
0 1 0 0 0 0 0 1 1 1 0 
0 1 0 1 0 1 0 1 0 1 0 
0 1 0 1 0 1 0 1 0 1 0 
0 11 0 1 0 1 0 1 1 1 0 
0 0 0 1 11 1 0 1 1 1 0 
0 11 1 1 0 1 0 1 1 1 0 
0 0 1 1 0 0 0 0 0 0 0 
0 0 0 1 1 12 0 1 13 1 1 
0 0 0 0 0 0 0 1 2 1 0 
0 0 0 1 0 0 0 0 0 1 1 
