430 120 2 6 2 1 1 1 1 240 230 360 28
3
0 0 1 1 1 0 0 0 0 0 0 
0 0 0 0 0 0 0 1 1 1 0 
0 0 5 7 0 1 0 0 14 1 0 
0 0 0 0 0 1 5 1 15 1 0 
0 11 0 1 0 1 6 1 1 1 0 
0 12 0 1 11 1 0 1 1 1 0 
8 0 1 1 0 1 4 1 1 1 0 
1 0 1 1 0 0 0 0 0 0 0 
0 0 0 1 1 12 0 1 13 1 1 
0 0 0 0 0 0 0 1 0 3 0 
0 0 0 1 0 0 0 0 0 1 1 
0 0 1 1 1 0 0 0 0 0 0 
0 1 0 0 0 0 0 1 1 1 0 
0 1 0 1 0 1 0 1 0 1 0 
0 1 0 1 0 1 0 1 0 1 0 
0 11 0 1 0 1 0 1 1 1 0 
0 0 0 1 11 1 0 0 1 13 0 
0 11 1 1 0 1 0 1 1 1 0 
0 0 1 1 0 0 0 0 0 0 0 
0 0 0 1 1 12 0 1 13 1 1 
0 3 0 0 0 0 0 1 2 1 0 
0 0 0 1 0 0 0 0 0 1 1 
2 0 0 0 0 0 0 0 0 0 0 
1 1 1 1 1 1 1 1 1 1 0 
6 0 0 5 0 1 0 0 0 1 0 
0 11 0 1 0 1 1 1 0 1 0 
4 0 0 1 0 0 11 13 12 1 0 
0 12 0 1 0 1 1 1 1 1 0 
1 0 1 1 0 0 0 0 0 0 0 
0 0 0 1 1 0 1 1 1 0 1 
6 0 5 1 5 0 0 1 0 12 14 
5 0 8 1 0 0 0 1 0 12 0 
0 0 0 1 0 0 0 1 0 13 5 
