510 50 5 4 1 1 1 1 1 0 0 80 70
6
0 0 1 1 1 0 0 0 0 0 0 
0 0 0 9 0 0 0 1 1 1 0 
0 0 0 0 0 1 0 14 9 1 0 
0 0 0 0 0 1 0 1 7 1 0 
101 11 0 1 0 1 0 1 1 1 0 
0 12 0 1 11 1 0 1 1 1 0 
8 0 1 1 0 1 4 1 1 1 0 
1 0 1 1 0 0 0 0 0 0 0 
0 0 0 1 1 12 0 1 13 1 1 
0 10 0 0 0 0 0 1 0 3 0 
0 0 0 1 0 15 0 0 0 1 1 
0 0 1 1 1 0 0 0 0 0 0 
0 1 0 0 0 0 0 1 1 1 0 
0 1 0 1 0 1 0 1 0 1 0 
0 1 0 1 0 1 0 1 0 1 0 
0 11 0 1 0 1 0 1 1 1 0 
0 0 0 1 11 1 0 0 1 13 0 
0 11 1 1 0 1 0 1 1 1 0 
0 0 1 1 0 0 0 9 0 0 0 
0 0 0 1 1 12 0 1 0 1 1 
0 3 0 0 0 0 12 1 2 1 0 
0 0 0 1 0 15 14 15 0 1 1 
2 0 0 0 0 0 0 0 0 0 0 
1 1 1 1 1 1 1 1 1 1 0 
0 0 0 0 0 1 0 0 0 1 0 
0 11 0 1 0 1 1 1 0 1 0 
4 0 0 1 0 0 11 13 12 1 0 
0 12 0 1 0 1 1 1 1 1 0 
1 0 1 1 0 0 0 0 0 0 0 
0 0 0 1 1 0 1 1 1 0 1 
6 0 5 1 0 0 0 1 0 0 0 
5 0 8 1 0 0 0 1 0 12 3 
0 0 0 1 0 9 0 1 0 13 0 
3 1 0 0 0 0 0 1 0 0 0 
0 1 0 0 1 0 0 1 0 0 0 
0 0 0 0 1 0 0 1 13 1 0 
1 1 1 0 1 0 0 1 6 1 0 
0 11 0 0 1 0 0 1 1 1 0 
0 12 0 11 1 0 0 0 0 0 0 
1 11 1 1 1 0 1 1 1 1 0 
0 0 0 0 1 0 1 9 0 0 0 
5 6 9 0 1 0 1 0 1 1 1 
1 1 1 1 1 0 1 0 1 11 7 
2 0 0 0 0 8 1 10 0 13 4 
2 1 0 0 1 0 12 0 5 14 0 
0 1 0 0 1 0 1 1 1 1 0 
0 1 1 0 1 0 1 6 9 15 0 
0 0 0 0 0 0 1 4 0 0 14 
0 1 1 1 1 0 1 1 1 1 1 
0 0 13 12 0 0 0 13 14 0 0 
1 1 1 1 1 0 1 1 1 1 0 
13 0 0 14 1 0 0 0 0 0 0 
0 14 0 7 1 0 1 1 0 1 0 
0 1 1 1 1 0 1 0 0 1 0 
0 5 0 0 14 0 1 0 0 1 3 
0 0 0 2 0 0 0 0 0 0 0 
0 0 0 0 0 0 0 0 0 0 0 
0 0 0 0 0 0 0 0 0 0 0 
0 0 0 0 0 0 0 0 0 0 0 
0 0 0 0 0 0 0 0 0 0 0 
0 0 0 0 0 0 0 0 0 0 0 
0 0 0 0 0 0 0 0 0 0 0 
0 0 0 0 0 0 0 0 0 0 0 
0 0 0 0 0 0 0 0 0 0 0 
0 0 0 0 0 0 0 0 0 0 0 
0 0 0 0 0 0 0 0 0 0 0 
