2
0 0 1 1 1 0 0 0 0 0 0 
0 0 0 0 0 0 0 1 1 1 0
0 0 5 6 0 1 0 1 0 1 0
0 0 0 0 0 1 5 1 0 1 0
0 11 0 1 0 1 6 1 1 1 0
0 12 0 1 11 1 0 1 1 1 0
8 0 1 1 0 1 4 1 1 1 0
1 0 1 1 0 0 0 0 0 0 0
0 0 0 1 1 12 0 1 13 1 1
0 0 0 0 0 0 0 1 0 3 0
0 0 0 1 0 15 14 15 14 1 1

0 0 1 1 1 0 0 0 0 0 0 
0 1 0 0 0 0 0 1 1 1 0
0 1 0 1 0 1 0 1 0 1 0
0 1 0 1 0 1 0 1 0 1 0
0 11 0 1 0 1 0 1 1 1 0
0 0 0 1 11 1 0 1 1 1 0
0 11 1 1 0 1 0 1 1 1 0
0 0 1 1 0 0 0 0 0 0 0
0 0 0 1 1 12 0 1 13 1 1
0 0 0 0 0 0 0 1 2 1 0
0 0 0 1 0 15 14 15 14 1 1
