1
0 0 1 1 1 0 0 0 0 0 0 
0 1 0 0 0 0 0 1 1 1 0
0 1 0 1 0 1 0 1 0 1 0
0 1 0 1 0 1 0 1 0 1 0
0 1 0 1 0 1 0 1 1 1 0
0 1 0 1 11 1 0 1 1 1 0
0 0 1 1 0 1 0 1 1 1 0
1 0 1 1 0 0 0 0 0 0 0
0 0 0 1 1 12 0 1 1 1 1
0 0 0 0 0 0 0 1 13 1 0
0 0 0 1 0 0 0 15 14 1 1
